15 15
1 0
###############
#             #
#  $          #
#             #
#             #
#    $  *     #
#       *     #
#  $$         #
#             #
#       $     #
#             #
#             #
#   $         #
#             #
###############
